First Name	Last Name	Affiliation
Abhi	Modak	Universita e INFN Trieste (IT)
Abhishek Kumar	Sharma	Aligarh Muslim University, Aligarh – 202002, INDIA.
Adam	Bzdak	AGH University of Krakow
Adam	Takacs	Heidelberg University
Aditya Prasad	Dash	University of California Los Angeles
Adrian	Meyer-Ahrens	Institute for Nuclear Physics, University of Münster
Adrian	Nassirpour	Sejong University
Adrian	Rodríguez Rodríguez	GSI Helmholtzzentrum für Schwerionenforschung GmbH
Adrian William	Romero Jorge	Frankfurt Institute for Advanced Studies/Goethe University Frankfurt
Agnieszka Ewa	Ogrodnik	Charles University (CZ)
Alba	Soto Ontoso	Universidad de Granada
Alberica	Toia	Goethe Uni. Frankfurt & GSI
Aleksas	Mazeliauskas	Heidelberg University (DE)
Aleksi	Kurkela	University of Stavanger (NO)
Alessandro	De Falco	Università/INFN Cagliari
Alexander	Adam	University of Wuppertal
Alexander	Ayriyan	University of Wroclaw & AANL
Alexander	Botvina	ITP, Goethe University, Frankfurt am Main
Alexander	Milov	Weizmann Institute of Science (IL)
Alexander	Schmah	GSI - Helmholtzzentrum fur Schwerionenforschung GmbH (DE)
Alexander Philipp	Kalweit	CERN
Alexandre	Suaide	Universidade de Sao Paulo (BR)
Alexandru	Manea	Institute of Space Science
Alexian	Lejeune	Czech Technical University in Prague (CZ)
Alice	Ohlson	Lund University
Aman	Dimri	Stony Brook University (US)
Ana	Marin	GSI - Helmholtzzentrum fur Schwerionenforschung GmbH (DE)
Analyce	Soto-Hernandez	Ohio State University (US)
Ananya	Rai	Yale University (US)
Anar	Rustamov	GSI Helmholtzzentrum für Schwerionenforschung GmbH
Andi	Mankolli	Vanderbilt University
Andre Govinda	Stahl	CERN
Andrea	Beraudo	INFN Torino
Andrea	Dainese	INFN - Padova
Andrea	Dubla	GSI
Andrea	Palermo	Stony Brook University
Andrea	Rossi	INFN, Padova (IT)
Andrea	Tavira Garcia	Université Paris-Saclay (FR)
Andrea	Vioque-Rodríguez	Universidad Complutense Madrid
Andrea Sofia	Triolo	CERN
Andreas	Kirchner	Duke University
Andreas Ulveseth	Mikalsen	University of Bergen (NO)
Andrej	Kugler	Nuclear Physics Institute CAS
Andrew	Gordeev	Duke University
André	Cordeiro	Laboratório de Instrumentação e Física de Partículas (LIP - Lisbon)
Angela	Badala	INFN - Sezione di Catania
Anjali	Nambrath	University of California Berkeley (US)
Ankita Singh	Nain	DAV College, Panjab University, Chandigarh
Anna	Horváth	HUN-REN WIGNER Research Centre for Physics, Eötvös Loránd University
Anna	Senger	FAIR
Annalisa	De Caro	University of Salerno and INFN
Annamaria	Chiarini	Goethe University
Ante	Bilandzic	Technical University of Munich
Anthony	Frawley	Florida State University
Anton	Andronic	Universität Münster (DE)
Anton Albert	Riedel	Technische Universitaet Muenchen (DE)
Antoni	Marcinek	Polish Academy of Sciences (PL)
Antoni	Szczurek	Institute of Nuclear Physics PAN and Rzeszow University
Antonio	Bozic	Goethe University Frankfurt
Antonio	Uras	Centre National de la Recherche Scientifique (FR)
Apurva	Narde	University of Illinois Urbana-Champaign
Aritra	Bandyopadhyay	West University of Timisoara
Arjun	Kudinoor	Massachusetts Institute of Technology
Arpith	Kumar	Central China Normal University
Aryaa	Dattamunsi	Indian Institute of Technology Madras (IN)
Asanosuke	Jinno	Kyoto University
Ashish	Pandav	Lawrence Berkeley National Lab
Ashutosh	Dash	Goethe University
Attila	Pasztor	Eötvös University
Austin	Baty	University of Illinois Chicago
Axel	Drees	Stony Brook University
Bade	Sayki	Los Alamos National Laboratory
Baochi	Fu	Bielefeld University
Bappaditya	Mondal	National Institute of Science Education and Research, Bhubaneswar, India
Barbara	Jacak	University of California Berkeley (US)
Barbara	Trzeciak	Czech Technical University in Prague
Barnabas	Porfy	HUN-REN Wigner Research Centre for Physics (HU)
Bastian	Brandt	University of Bielefeld
Batoul	Diab	CERN
Beatrice	Liang-Gilman	University of California Berkeley (US)
Beatriz	Artur	Goethe-Universität, IKF
Bedangadas	Mohanty	National Institute of Science Education and Research (NISER) (IN)
Behruz	Kardan	Goethe-University Frankfurt (IKF)
Ben	Bert	University of Cape Town
Benedict	Heybeck	Goethe University Frankfurt (DE)
Benjamin	Dönigus	Johann-Wolfgang-Goethe Univ. (DE)
Bernd-Jochen	Schaefer	JLU Gießen
Berndt	Mueller	Duke University
Bhagyarathi	Sahoo	Indian Institute of Technology Indore (IN)
Bianca	Sabiu	Universita e INFN, Bologna (IT)
Biao	Zhang	Heidelberg university(DE)
Bill	Zajc	Columbia University
Bithika	Karmakar	University of Wroclaw
Bjoern	Schenke	Brookhaven National Laboratory
Blair Daniel	Seidlitz	Columbia University (US)
Boleslaw	Wyslouch	MIT
Bong-Hwi	Lim	INFN Torino (IT)
Boris	Hippolyte	IPHC / Université de Strasbourg (FR)
Boris	Tomasik	Czech Technical University in Prague (CZ)
Bruno	Scheihing	KITP, University of California, Santa Barbara
Byungsik	Hong	Korea University
Børge S.	Nielsen	Niels Bohr Institute, Uni Copenhagen
Caio	Brito	Universidade Federal Fluminense
Camilla	De Angelis	Universita e INFN, Cagliari (IT)
Carl	Rosenkvist	Frankfurt Institute for Advanced Studies
Carlos	Lamas	IGFAE-USC
Carlota	Andres	Massachusetts Institute of Technology
Carolina Anna	Reetz	Heidelberg University (DE)
Carsten	Greiner	ITP Goethe Unversity of Frankfurt, Dept. of Theoretical Physics
Catalin-Lucian	Ristea	Institute of Space Science subsidiary of INFLPR (RO)
Cedric	Riedel	Universität Bielefeld
Chandrodoy	Chattopadhyay	North Carolina State University
Changhwan	Choi	Pusan National University (KR)
Charles	Gale	McGill University
Charles	Robertson III	Purdue University
Chathuranga	Sirimanna	Duke University
Cheng-Wei	Shih	National Central University (TW) / RIKEN (JP)
Chenlu	Hu	University of Chinese Academy of Sciences
Chenyan	Li	Shandong University
Chenzhi	Dong	Tsinghua University (CN)
Chi	Yang	Shandong University
Chi	ZHANG	CEA-Saclay
Chiara	De Martin	Universita e INFN Trieste (IT)
Chiara	Le Roux	Lund University
Chiara	Oppedisano	INFN Torino (IT)
Chiara	Pinto	CERN
Chik Him	Wong	University of WUppertal
Christian	Bierlich	Lund University
Christian	Caron	Springer
Christian	Ecker	Goethe University Frankfurt
Christian	Fischer	University of Giessen, Germany
Christian	Klein-Bösing	Universität Münster
Christian	Pauly	Bergische Universität Wuppertal
Christian	Schmidt	Bielefeld University
Christian	Sturm	GSI Helmholtzzentrum GmbH
Christian	Wendisch	GSI Helmholtzzentrum Darmstadt
Christian Joachim	Schmidt	GSI Helmholtzzentrum
Christina	Markert	University of Texas at Austin (US)
Christof	Roland	MIT
Christoph	Blume	University of Frankfurt
Christoph	Herold	Suranaree University of Technology
Christopher	McGinn	Massachusetts Inst. of Technology (US)
Chun	Shen	Wayne State University
Chunjian	Zhang	Fudan University
CHUNTAI	WU	Padova University
Claude Andre	Pruneau	Wayne State University (US)
Claudia	Hoehne	Justus Liebig University Gießen
Clemens	Werthmann	Ghent University
Coleridge	Faraday	University of Cape Town
Cong	Yi	University of Science and Technology of China
Constantin	Sporleder	University of Jyväskylä
Constantinos	Loizides	CERN
Cornelius	Feier-Riesen	JLU Gießen
Cristian	Baldenegro	Massachusetts Inst. of Technology (US)
Cristina	Terrevoli	Universita e INFN, Bari (IT)
Cynthia	Hadjidakis	Université Paris-Saclay (FR)
Dai-Neng	Liu	Fudan University
Daicui	Zhou	Central China Normal University
Daiki	Sekihata	University of Tokyo (JP)
Dairon	Rodriguez Garces	GSI and Goethe University of Frankfurt
Dana	Avramescu	University of Jyväskylä
Daniel	Lis	University of Colorado Boulder
Daniel	Pablos	Universidade de Santiago de Compostela
Daniel	Tapia Takaki	University of Kansas
Dario Alberto	Ramirez Zaldivar	GSI Helmholtzzentrum für Schwerionenforschung GmbH
Dariusz	Miskowiec	GSI Darmstadt
David	Blaschke	University of Wroclaw and HZDR/CASUS Görlitz
David	Dobrigkeit Chinellato	Austrian Academy of Sciences (AT)
David	Emschermann	GSI
David	Gutiérrez Menéndez	GSI Helmholtzzentrum für Schwerionenforschung
David	Silvermyr	Lund University
David	Wagner	Florence University
Debadatta	Behera	Indian Institute of Technology Indore (IN)
Debarshi	Dey	Indian Institute of Technology Bombay
Debojit	Sarkar	Niels Bohr Institute, Copenhagen
Debora	Mroczek	University of Illinois Urbana-Champaign
Deekshit	Kumar	Homi Bhabha National Institute Mumbai, India
Deependra	Sharma	IIT- Indian Institute of Technology (IN)
Dennis	Perepelitsa	University of Colorado Boulder
Dennis	Spicker	Goethe University Frankfurt - IKF
Derek	Teaney	Stony Brook University
Diana	Krupova	Czech Technical University in Prague (CZ)
Dieter	Roehrich	University of Bergen (NO)
Dingwei	Zhang	South China Normal University (CN)
Dirk	Rischke	Goethe University Frankfurt am Main
Diyu	Shen	Fudan University
Dmitry	Shemyakin	Weizmann Institute of Science (IL)
Dominik Karol	Derendarz	Polish Academy of Sciences (PL)
Dong Jo	Kim	University of Jyvaskyla (FI)
Dongguk	Kim	Sungkyunkwan University (KR)
Dylan	Neff	CEA-Saclay
Dániel	Kincses	Eötvös Loránd University
Eamonn	Weitz	Universität Bielefeld
Eduardo	Fraga	Instituto de Física, Universidade Federal do Rio de Janeiro
Ejiro Naomi	Umaka	Brookhaven National Laboratory (US)
Elena	Bratkovskaya	GSI, Darmstadt & Frankfurt Univ.
Emil Gorm	Nielsen	University of Copenhagen (DK)
Emilie Martine	Barreau	Centre National de la Recherche Scientifique (FR)
Emma	Ege	Goethe Universität Frankfurt
Emma	McLaughlin	Columbia University
Emma Rose	Yeats	University of California Berkeley (US)
Enrico	Scomparin	INFN Torino (IT)
Enrico	Speranza	CERN
Eoin	Clerkin	FAIR - Facility for AntiProton and Ion Research in Europe GmbH
Eslam	Shokr	Zurich University
Esther	Bartsch	Goethe University Frankfurt (DE)
Ezra D.	Lesser	CERN
Fabian	Rennecke	Justus Liebig University Giessen
Fabio	Colamaria	INFN, Sezione di Bari (IT)
Fabrizio	Chinu	Universita e INFN Torino (IT)
Fabrizio	Grosa	CERN
Fan	Si	University of Science and Technology of China
Farid	Salazar	Temple University
Federica	Capellino	GSI Darmstadt
Federico	Antinori	Universita e INFN, Padova (Italy)
Feng	Liu	Central China Normal University
Feng-lei	Liu	Central china normal university
Ferdinando	Frascà	INFN - sezione di Torino
Fernando	Gardim	Federal University of Alfenas
Florian	Alef	Technische Universität Darmstadt
Florian	Eisenhut	Goethe University Frankfurt (DE)
Florian	Jonas	University of California Berkeley (US)
Florian	Lindenbauer	TU Wien
Florian	Seck	TU Darmstadt / GSI
Francesca	Ercolessi	Universita e INFN, Bologna (IT)
Francesco	Giacosa	Kielce University
Francesco	Mazzaschi	CERN
Franciszek	Pauwels	Charles University (CZ)
Frank	Geurts	Rice University (US)
Frank	Gonzalez	University of California, Davis
Franz	Matejcek	Goethe-Universität Frankfurt, Institut für Kernphysik
Frithjof	Karsch	Bielefeld University
Fu	Ma	Fudan University
Fu-Peng	Li	Central China Normal University
Fuqiang	Wang	Purdue University
Gabor	David	Stony Brook University
GABRIEL	DALE-GAU	University of Illinois at Chicago
Gabriel	Rabelo Soares	University of Campinas - UNICAMP - BR
Gabriel	Silveira Denicol	Universidade Federal Fluminense
Gabriel	Soares Rocha	Universidade Federal Fluminense
Gabriele	Coci	University of Catania & INFN-LNS
Gabriele	Parisi	University of Catania
Gang	Wang	UCLA
Gergely	Endrodi	Eotvos University Budapest
Gergely Gabor	Barnafoldi	HUN-REN Wigner Research Centre for Physics (HU)
Giacomo	Alocco	Universita e INFN, Torino (IT)
Gian Michele	Innocenti	Massachusetts Inst. of Technology (US)
Gianluca	Usai	Universita e INFN, Cagliari (IT)
Gines	Martinez-Garcia	Subatech CNRS
GIulia	Manca	Universita` degli studi di Cagliari and INFN, Cagliari, IT
Giuseppe	Bruno	Dipartimento di Fisica "M Merlin" and INFN, Bari (IT)
Gleb	Romanenko	Universita e INFN, Bologna (IT)
Govert	Nijs	CERN
Gowthama	K K	Indian Institute of Technology Bombay
Grazia	Luparello	INFN Trieste (IT)
Greg	Jackson	Subatech (CNRS/IN2P3)
Gregory	Ottino	Lawrence Berkeley National Laboratory
Grigory	Nigmatkulov	University of Illinois Chicago
Guang-You	Qin	Central China Normal University
Guangyu	Zheng	University of Chinese Academy of Sciences
Gunther	Roland	MIT
Guoping	Wang	Central China Normal University
Guy	Moore	TU Darmstadt
Gyeonghwan	Bak	Chonnam National University (KR)
Gyula	Bencedi	HUN-REN Wigner Research Centre for Physics (HU)
Gábor	Papp	Eötvös Loránd University
Hadi	Mehrabpour	Peking Univresity
Han	Gao	McGill University
Han-Sheng	Li	Purdue University
Hanna	Zbroszczyk	Warsaw University of Technology (PL)
Hannah	Bossi	Massachusetts Inst. of Technology (US)
Hannah	Elfner	GSI/Goethe Uni
Hans Rudolf	Schmidt	GSI Helmholtzzentrum für Schwerionenforschung GmbH(GSI) & University of Tübingen
Hanseo	Park	University of Tsukuba (JP)
HANWEN	FENG	Central China Normal University
Hao-Lei	Chen	Fudan University
Hao-Ren	Jheng	Massachusetts Inst. of Technology (US)
Harald	Appelshaeuser	Goethe University Frankfurt (DE)
Harri	Niemi	University of Jyväskylä
Harshit	Pandey	The Institute of Mathematical Sciences, Chennai, India
Heikki	Mäntysaari	University of Jyväskylä
Helen	Caines	Yale University (US)
Hendrik	Roch	Wayne State University
Hendrik	van Hees	Goethe University Frankfurt
Heng-Tong	Ding	Central China Normal University
Henner	Buesching	Goethe University Frankfurt (DE)
Henry	Hirvonen	Vanderbilt University
Herbert	Stroebele	Goethe University Frankfurt (DE)
Hikari	Murakami	KMI, Nagoya
Himanshu	Sharma	Universita e INFN, Padova (IT)
Hitansh	Shah	University of Houston
Hongcan	Li	Central China Normal University
Horst Sebastian	Scheid	CERN
Hosein	Gholami	TU Darmstadt
Huan	Huang	University of California Los Angeles
Huda	Nasrulloh	University of Science and Technology of China
Huichao	Song	Peking U
Hyungjun	Lee	Sungkyunkwan University (KR)
Hyunji	Lim	Pusan National University (KR)
Ian	Bearden	Niels Bohr Institute
Ian	Cordeiro	University of Illinois at Urbana-Champaign
Ida	Storehaug	University of Oslo (NO)
Ilia	Grishmanovskii	ITP, Frankfurt
Ilya	Fokin	Heidelberg University (DE)
Ilya	Selyuzhenkov	GSI, Darmstadt
Imanol	Corredoira	CEA/IRFU
In Kwon	Yoo	Pusan National University (KR)
Ingo	Deppner	GSI Helmholtzzentrum für Schwerionenforschung GmbH
Ingrid Mckibben	Lofnes	University of Bergen (NO)
Ionut Cristian	Arsene	University of Oslo (NO)
Iouri	Vassiliev	GSI
Irakli	Keshelashvili	GSI Helmholtzzentrum für Schwerionenforschung GmbH
Iris	Likmeta	University of Houston
Isaac	Mooney	Yale University
Isabela	Maietto Silverio	UNESP - Universidade Estadual Paulista (BR)
Isabella	Danhoni	University of Illinois Urbana-Champaign
Ishfaq Ahmad	Rather	ITP, Goethe University, 60438 Frankfurt am Main, Germany
ismail	soudi	University of Jyvaskyla
Isobel	Kolbe	University of the Witwatersrand (ZA)
Itzhak	Tserruya	Weizmann Institute
Iuliana-Carina	Udrea	TU Darmstadt/GSI
Ivan	Vorobyev	CERN
Iwona	Grabowska-Bold	AGH University of Krakow (PL)
Jacek Tomasz	Otwinowski	Institute of Nuclear Physics Polish Academy of Sciences (PL)
Jack	Holguin	The University of Manchester
Jacquelyn	Noronha-Hostler	University of Illinois Urbana-Champaign
Jaebeom	Park	University of Colorado Boulder
Jaehyeok	Ryu	Pusan National University (KR)
Jaein	Hwang	Korea University
Jaeyoon	Cho	Inha University (KR)
Jakob Elias	Lohr	ITP Frankfurt
Jakub	Ceska	Czech Technical University in Prague
James Lawrence	Nagle	University of Colorado Boulder
Jamie	Karthein	Massachusetts Institute of Technology
Jan	Orlinski	Faculty of Physics, University of Warsaw
Jan	Rais	Goethe University Frankfurt am Main
Jan	Scharf	Goethe University Frankfurt (DE)
Jan	Schöngarth	Goethe University Frankfurt (DE)
Jan	Steinheimer-Froschauer	GSI
Jan	Vanek	Brookhaven National Laboratory
Jan	Wissmann	Universität Münster
Jan Fiete	Grosse-Oetringhaus	CERN
Jan M.	Pawlowski	Heidelberg University
Jan Philipp	Klinger	Goethe University Frankfurt
Jana	Bielcikova	Czech Academy of Sciences (CZ)
Jana N.	Guenther	University of Wuppertal
Janik	Ditzel	Goethe University Frankfurt (DE)
Janis	Jäger	Goethe University Frankfurt (DE)
Jannis	Gebhard	Heidelberg University
Jasmine	Brewer	University of Oxford
Jasper	Parkkila	Warsaw University of Technology
Jean	Du Plessis	Massachusetts Institute of Technology
Jean-Francois	Paquet	Vanderbilt University
Jean-Yves	OLLITRAULT	IPhT Saclay
Jens	Wiechula	Goethe University Frankfurt (DE)
Jens Andreas	Hügel	Universität Bielefeld
Jerome	Jung	Goethe University Frankfurt (DE)
Jerzy	Pietraszko	GSI Darmstadt
Jeseleth	Van Rose	Vanderbilt University
Jesper	Karlsson Gumprecht	Austrian Academy of Sciences (AT)
Jessica Ou Ya	Vogel	TU Darmstadt
Jhoao Gabriel	Martins Campos Almeida Arneiro	Universidade de Sao Paulo (BR)
Jia Lin	Pei	Fudan University
Jiangyong	Jia	Stony Brook University (US)
Jianhui	Zhu	Fudan University
Jianqiao	Wang	Tsinghua University (CN)
Jiaxing	Zhao	HFHF/Goethe University
Jiaxuan	Luo	USTC
JiaZhao	Lin	Rice University (US)
Jie	Zhu	Bielefeld University
Jin-Biao	Gu	Central China Normal University
Jing	An	Central China Normal University
Jing	Wang	CERN
JINGAN	SUN	Fudan University
Jingyu	Zhang	Fudan university
Jinhyun	Park	Pusan National University (KR)
Jinlong	Zhang	Shandong University
Jishnu	Goswami	Bielefeld University
Joachim	Hansen	Lund University (SE)
Joachim	Stroth	Goethe University Frankfurt / GSI
Joakim	Nystrand	University of Bergen (NO)
Joao	Lourenco Henriques Barata	CERN
Joe	Osborn	Brookhaven National Laboratory
Joerg	Aichelin	SUBATECH
Joern	Putschke	Wayne State University
Joey	Staa	Lund University (SE)
Johann M.	Heuser	GSI Helmholtzzentrum für Schwerionenforschung GmbH
Johanna	Stachel	Heidelberg University (DE)
Johannes	Keul	IKF, Goethe Universität Frankfurt
Johannes	Pöplau	Goethe University Frankfurt
Johannes	Roth	Justus-Liebig-Universität Gießen
John	Harris	Yale University
Jonas	Turnwald	TU Darmstadt
Jonas	Winter	Technische Universität Darmstadt
Jonathan	Parra	University of Houston
Joonsuk	Bae	Sungkyunkwan University (KR)
Jorge	Noronha	University of Illinois Urbana-Champaign
Jorge Luis	Golan Dasilva	Brookhaven National Laboratory
Jorge Manuel	Martínez Vera	Università degli Studi di Torino & Universitat de Barcelona
Joscha	Egger	FIAS/GU Frankfurt
Joseph	Atchison	Abilene Christian University
Joseph	Kapusta	University of Minnesota
Joshua	König	Goethe Universität Frankfurt (DE)
João	A. Gonçalves	LIP - IST
João	Silva	LIP-Lisbon / ULisboa-IST
João Paulo	Sampaio Santos	UERJ
Juan	Torres-Rincon	Universitat de Barcelona
Juergen	Eschke	FAIR GmbH (DE)
Juergen	Eser	Frankfurt University
Julia	Sammet	Goethe Universität Frankfurt/ITP
Julia	Velkovska	Vanderbilt University
Juliette	Authier	Laboratoire Leprince-Ringuet, CNRS (FR)
Julio	Andary	Goethe-Universität Frankfurt
Junlee	Kim	CERN
Junyi	Han	Central China Normal University, Heidelberg University
Jurgen	Schukraft	University of Copenhagen (DK)
Jussi	Auvinen	University of Jyväskylä
Jussi	Viinikainen	Vanderbilt University (US)
Justin	Mauldin	Frankfurt University
Jürgen	Schaffner-Bielich	Goethe University
Jędrzej	Kołaś	Warsaw University of Technology
Kai	Schweda	GSI - Helmholtzzentrum fur Schwerionenforschung GmbH (DE)
Kai	Zhou	CUHK-Shenzhen
KaiJia	Sun	Institute of Modern Physics, Fudan University, Shanghai, China
Kaiyang	Wang	University of Science and Technology of China
Kaiyi	Wu	CCNU
Kangkan	Goswami	Indian Institute of Technology Indore
Kari	Eskola	University of Jyvaskyla
Karina	Scharmann	Justus-Liebig-Universität Gießen
Karl-Heinz	Kampert	University Wuppertal
Kartik Deepak	Bhide	University of Freiburg (DE)
Katarzyna	Grebieszkow	Warsaw University of Technology (PL)
Kayman	Gonçalves	University of Campinas
Kayran	Schmidt	TU Wien
Ke	Mi	Central China Normal University
Kehao	Zhang	Central China Normal University
Keiwan	Jamaly	Goethe University Frankfurt
Kenta	Shigaki	Hiroshima University (JP)
Kevin	Possendoro Pala	University of Illinois Urbana-Champaign / University of São Paulo
Khwahish	Kushwah	Universidade Federal Fluminense (UFF), Rio de Janeiro, Brazil
Kirill	Boguslavski	TU Wien (AT)
Klaus	Reygers	Heidelberg University
Korinna	Zapp	Lund University
Koshiro	Yoda	University of Tsukuba (JP)
Krishna	Rajagopal	Massachusetts Inst. of Technology (US)
Krista Lizbeth	Smith	Pusan National University (ROK)
Kristina	Totic	Goethe University
Krzysztof	Piasecki	University of Warsaw
Lang	Xu	Central China Normal University CCNU (CN) / Institut de Physique des 2 Infinis de Lyon IP2I (FR)
Laszlo	Gyulai	HUN-REN Wigner RCP
Laura	Gans-Bartl	Goethe University Frankfurt
Laura	Havener	Yale University
Laura	Huhta	University of Jyvaskyla (FI)
Laura	Sagunski	Goethe University Frankfurt
Laura	Tolos	ICE (CSIC, Barcelona)
Laura	Šerkšnytė	CERN
Leon	Sieke	Justus-Liebig-Universität Giessen
Leonardo	Barreto	Universidade de Sao Paulo (BR), Universität Münster (DE)
Leonardo	Tinti	Uniwersytet Jana Kochanowskiego w Kielcach
Leopoldo	Abranches de Carvalho	Universidade de São Paulo
Li	Yan	Fudan University
Lida	Kalipoliti	LLR, École Polytechnique (FR)
Lijuan	Ruan	Brookhaven National Laboratory
like	liu	Central China Normal University
Liliana	Apolinario	LIP (PT)
Lin	CHEN	Instituto Galego de Fisica de Altas Enerxias - IGFAE
Lisa	Kröger	Bielefeld University
Liubing	Chen	Central China Normal University
LIYUAN	ZHANG	Fudan University
Lorenz	von Smekal	JLU Giessen
Lorenzo	Bernardinis	Universita e INFN Trieste (IT)
Lorenzo	Gavassino	Vanderbilt University
Lu-Meng	Liu	Fudan University
Luca	Aglietta	University of Turin
Luca	Quaglia	INFN Torino (IT)
Lucas	Constantin	Goethe-Universität
Lucia	Oliva	University of Catania, Department of Physics and Astronomy - INFN Catania
Lucia Anna	Tarasovicova	Pavol Jozef Safarik University (SK)
Luciano	Rezzolla	Institute for Theoretical Physics, Frankfurt, Germany
Ludovica	Pirelli	Bergische Universität Wuppertal
Luigi	Dello Stritto	CERN
Luis	Alcerro	The University of Kansas (US)
Luthien	Mlynarski	AGH University of Krakow (PL)
Lutz	Kiefer	Goethe University
László	Kovács	Eötvös Loránd University
Magdeline	Seabi	Nelson Mandela University
Magnus	Mager	CERN
Magnus	Thoegersen	University of Oslo (NO)
Mahboubeh	Shahrbaf Motlagh	University of Wroclaw
Mai	Takamura	Nara
Maja	Mackowiak-Pawlowska	Warsaw University of Technology (PL)
Maksym	Teklishyn	GSI
Malgorzata	Gumberidze	GSI Helmholtzzentrum fuer Schwerionenforschung Gmbh
Maneesha	Sushama Pradeep	University of Maryland College Park
Manjunath	Omana Kuttan	Frankfurt Institute for Advanced Studies
Manuel	Calderon De La Barca	UC Davis
Manuel	Lorenz	Goethe-University Frankfurt
Manuel	Ramirez Garcia	University of Michigan (US)
Maowu	Nie	Shandong University (CN)
Marc	Winstel	Goethe University, Frankfurt am Main
Marc-André	Petri	Bergische Universität Wuppertal
Marcello	Di Costanzo	Politecnico di Torino (IT)
Marcelo	Gameiro Munhoz	Universidade de Sao Paulo (BR)
Marco	Leitão	LIP - Lisbon
Marco	van Leeuwen	Nikhef and CERN
Marcus	Bleicher	Uni Frankfurt
Marek	Gazdzicki	Jan Kochanowski University (PL)
Maria Alejandra	Calmon Behling	Goethe University Frankfurt (DE)
Maria Lucia	Sambataro	University of Catania - Department of Physics and Astronomy
Marie	Germain	Subatech, IN2P3-CNRS (FR)
Mariia	Mitrankova	Stony Brook University
Mario	Ciacco	Universita' and INFN Torino (IT)
Mario	Krüger	Institut für Kernphysik Frankfurt
Marta	Urioni	Universita e INFN Trieste (IT)
Marten	Becker	Justus-Liebig-Universität Gießen
Martin	Rybar	Charles University (CZ)
Martin	Spousta	Charles University
Martin Andreas	Volkl	University of Birmingham (GB)
Marton	Nagy	ELTE Eötvös Loránd University
Marvin	Hemmer	Goethe University Frankfurt (DE)
Marvin	Kohls	GSI Helmholtzzentrum für Schwerionenforschung GmbH
Marvin	Nabroth	Goethe University Frankfurt
Maryann	Collazo Sánchez	Goethe University Frankfurt
Masakiyo	Kitazawa	YITP, Kyoto
Masayuki	Asakawa	Osaka University
Masoud	Shokri	Goethe university
Mate	Csanad	Eotvos University, Budapest
Mateusz	Dyndal	AGH University of Krakow
Mateusz	Ploskon	Lawrence Berkeley National Lab. (US)
Mateusz Ludwik	Bajda	Jagiellonian University (PL)
Mathias	Labonte	University of California, Davis
Mathias Pavely	Nødtvedt	NTNU
Matisse	De Lescluze	Ghent University
Matteo	Buzzegoli	West University of Timisoara
Matthew	William Luzum	University of São Paulo
Matthew Caleb	Hoppesch	University of Illinois at Urbana-Champaign
Matthias	Kaminski	The University of Alabama
Matthias	Kleiner	Goethe University Frankfurt (DE)
Matthias	Richter	University of Bergen (NO)
Mattia	Faggin	CERN
Mattis	Harhoff	Universität Bielefeld
Maurice	Coquet	Centre National de la Recherche Scientifique (FR)
Max Philip	Rauch	University of Bergen (NO)
Maxim	Virta	University of Jyväskylä
Maximilian	Mahlein	Technische Universitaet Muenchen (DE)
Maximiliano	Puccio	CERN
Mayank	Singh	Vanderbilt University
Megan	Connors	Georgia State University
Mehulkumar	Shiroya	GSI Helmholtzzentrum für Schwerionenforschung GmbH
Meike Charlotte	Danisch	Pusan National University (KR)
Menghsiu	Kuo	University of Tsukuba (JP)
Mesut	Arslandok	Yale University (US)
Michael	Hartung	Institut für Kernphysik, Goethe University Frankfurt
Michael	Jung	Institut fuer Kernphysik Frankfurt
Michael	Peters	Massachusetts Institute of Technology (MIT)
Michael	Winn	Université Paris-Saclay (FR)
Michal	Heller	Ghent University
Michal	Svoboda	Nuclear Physics Institute, Czech Academy of Sciences
Michał	Marczenko	University of Wrocław
Michał	Prędota	Warsaw University of Technology, Faculty of Physics
Michał	Szymański	University of Wroclaw
Mika Sebastian	Spier	Universität Bielefeld/Université Paris-Saclay
Mike	Sas	Nikhef National institute for subatomic physics (NL)
Mikhail	Stephanov	University of Illinois Chicago
Milan	Stojanovic	Wayne State University
Min	He	Nanjing University of Science & Technology
Minjae	Kim	Pusan National University (KR)
Minjung	Kim	UC Berkeley
MinJung	Kweon	Inha University
Moe	Isshiki	University of Tsukuba
Mohammad	Nasim	IISER Berhampur
Motoi	Inaba	Tsukuba University of Technology (JP)
Muhammad Farhan	Taseer	Institute of Modern Physics, Chinese Academy of Sciences, Lanzhou, China
Mykhailo	Hontarenko	Institute of Theoretical Physics Jagiellonian University
Nadine Alice	Gruenwald	Heidelberg University (DE)
Naomi	Oei	Goethe University Frankfurt
Naseem	Bouchhar	Sejong University
Natalia	Łygan	Institute of Theoretical Physics, Jagiellonian University, Kraków
Navid	Abbasi	Lanzhou University
Neelkamal	Mallick	University of Jyväskylä, Finland
Nicholas	Jindal	Ohio State University (US)
Nicki	Mullins	Illinois Urbana Champaign
Nicola	Nicassio	University and INFN, Bari, Italy
Nicolas	Borghini	Bielefeld University
Nicolas	Strangmann	Goethe University Frankfurt (DE)
Nicolas	Tiltmann	CERN, Universität Münster (DE)
Nicolò	Jacazio	Universita e INFN, Bologna (IT)
Nihar Ranjan	Saha	Indian Institute of Technology, Madras (IN)
Nikhil	Kumar	The CUNY Graduate Center
Niklas	Götz	Goethe University
Niklas	Schild	TU Darmstadt
Nils	Sass	Goethe University Frankfurt
Nima	Zardoshti	CERN
Nina	Nathanson	Niels Bohr Institute
Noor	Koster	Nikhef
Noriyuki	Sogabe	University of Illinois Chicago
Nu	Xu	Institute of Modern Physics
Nuno Olavo	Gonçalves Mendes Madureira	LIP/IST
Oana	Ristea	University of Bucharest, Faculty of Physics
Ofentse	Matlhakola	University of the Witwatersrand
Olaf	Massen	Utrecht University
Oleksandr	Vitiuk	University of Wroclaw (PL)
Oleksii	Ivanytskyi	University of Wroclaw
Oleksii	Lubynets	Heidelberg University
Omar	Perez Figueroa	JLU Giessen
Omar	Vazquez Rueda	University of Houston (US)
Ondrej	Lomicky	Czech Technical University in Prague
Oscar	Garcia-Montero	Universität Bielefeld
Oton	Vazquez Doce	INFN e Laboratori Nazionali di Frascati (IT)
Owe	Philipsen	Goethe University Frankfurt
Paolo	Parotto	Università and INFN Torino
Pasi	Huovinen	University of Wroclaw
Patricia	Rebello Teles	Brazilian Center for Physics Research - CBPF (BR)
Patrik	Novotny	Weizmann Institute of Science (IL)
Patrycja	Potępa	AGH Kraków / JGU Mainz
Pavan	Pavan	Bielefeld University
Pavel	Vana	Charles University (CZ)
Pavish	Subramani	Bergische Universitaet Wuppertal
Pei	Li	Fudan University
Pengzhong	Lu	University of Science and Technology of China (CN)
Peter	Braun-Munzinger	GSI - Helmholtzzentrum fur Schwerionenforschung GmbH (DE)
Peter	Christiansen	Lund University (SE)
Peter	Koch-Steinheimer	Institut für Theoretische Physik JWG-Universität Frankfurt am Main
Peter	Lowdon	Goethe University Frankfurt
Peter	Senger	FAIR
Peter	Stratmann	Universität Münster (DE)
Petr	Balek	AGH University of Krakow (PL)
Petr	Chaloupka	Czech Technical University in Prague
Philipp	Kähler	Universität Münster
Pierre-Alain	Loizeau	GSI - Helmholtzzentrum fur Schwerionenforschung GmbH (DE)
Piotr	Gasik	GSI/FAIR + TU Darmstadt
Pol-Bernard	GOSSIAUX	Subatech
Pooja	Pooja	University of Jyväskylä
Prabhat Ranjan	Pujahari	Indian Institute of Technology Madras (IN)
Pracheta	Singha	west university of Timisoara
Pranjal	Verma	Indian Institute of Technology Madras (IN)
Prasanjit	Aich	Indian Institute of Science, Bangalore
Preet Bhanjan	Pati	University of Copenhagen (DK)
Preeti	Dhankher	University of California Berkeley (US)
Pritam	Chakraborty	Warsaw University of Technology, Poland
Prottay	Das	CERN
Qiang	HU	Institute of Modern Physics, Chinese Academy of Sciences
Qinghua	Xu	Shandong University
Qiye	Shou	Fudan University (CN)
Qun	Wang	University of Science and Technology of China
Rachel	Steinhorst	Massachusetts Institute of Technology
Radim	Dvorak	Czech Technical University in Prague
Rahul	Verma	IIT- Indian Institute of Technology (IN)
Raimond	Snellings	Nikhef National institute for subatomic physics (NL)
Rainer	Fries	Texas A&M University
Rajeev	Singh	West University of Timisoara, Romania
Raju	Venugopalan	Brookhaven National Laboratory
Ralf	Averbeck	GSI - Helmholtzzentrum für Schwerionenforschung GmbH
Ralf	Keidel	ZTT, Hochschule Worms, Erenburgerstraße 19, 67549 Worms
Ralf	Rapp	Texas A&M University
Ramona	Vogt	LLNL and UC Davis
Raphaelle	Bailhache	Goethe University Frankfurt (DE)
Rasmus	Larsen	Bielefeld University
RAVI	SHANKER	The Institute of Mathematical Sciences
Rebecca	Cerri	Universita e INFN Torino (IT)
Reinhold	Kaiser	Goethe University Frankfurt
Ren	Ejima	Hiroshima University
Renan	Góes-Hirayama	FIAS
Renata	Krupczak	Universität Bielefeld
Riccardo	Longo	Univ. Illinois at Urbana Champaign (US)
Richard	Seto	University of California, Riverside
Risto	Paatelainen	University of Helsinki
Robbe	Brants	Ghent University
Roberta	Arnaldi	INFN Torino (IT)
Robin	Sattler	Goethe University Frankfurt
Robin	Törnkvist	IGFAE, Universidade de Santiago de Compostela
Rohit Kumar	Singh	Indian Institute of Technology Madras (IN)
Roli	Esha	Stony Brook University
Romain	Schotter	Stefan Meyer Institute for Subatomic Physics of the Austrian Academy of Sciences (AT)
Roman	Nepeivoda	Lund University (SE)
Rudrapriya	Das	Bose Institute
Rupam	Samanta	Institute of Nuclear Physics (IFJ, PAN), Poland
Rutik	Manikandhan	University of Houston
Sabarnya	Mitra	Bielefeld University
Sabina	Krasilovskaja	Goethe University
Sadhana	Dash	IIT Bombay
Saeahram	Yoo	University of California Davis (US)
Saehanseul	Oh	Sejong University
Sahil	Upadhyaya	Institute of Nuclear Physics Polish Academy of Sciences (PL)
Salvatore	Plumari	University of Catania, Department of Physics and Astronomy 'E. Majorana'
Samapan	Bhadury	Jagiellonian University
Samuel	Belin	Universidade de Santiago de Compostela (ES)
Samuel	Corey	Ohio State University
Samuele	Cattaruzzi	Universita e INFN Trieste (IT)
Sangyong	Jeon	McGill University
Sara	Garetti	Université Paris-Saclay (FR)
Sarah Louisa	Pitz	Goethe Universität Frankfurt am Main
Sarjeeta	Gami	National Institute of Science Education and Research (NISER) (IN)
Saverio	Mariani	CERN
Sawan	Sawan	National Institute of Science Education and Research (NISER) (IN)
Sayan	Chatterjee	Indian Institute of Technology Madras (IN)
Sayantan	Sharma	The Institute of Mathematical Sciences
Selina	Kunkel	Goethe University
Semen	Potesnov	Institute for Theoretical Physics, Goethe-University Frankfurt
Sergio	Barrera Cabodevila	Instituto Galego de Física de Altas Enerxías - Universidade de Santiago de Compostela
Sergio	Morales Tejera	West University of Timisoara
Seyed Farid	Taghavi	Technical University of Munich (TUM)
SHARANG RAV	SHARMA	Indian Institute of Science Education and Research Tirupati
Shi	Pu	University of Science and Technology of China
Shihai	Jia	University of Copenhagen (DK)
Shin-ei	Fujii	Sophia Univ.
Shingo	Sakai	University of Tsukuba (JP)
Shinichi	Esumi	University of Tsukuba (JP)
Shirajum	Monira	Warsaw University of Technology (PL)
Shreyasi	Acharya	Universita e INFN, Bari (IT)
Shuai	Yang	South China Normal University
Shuang	Guo	Fudan university
Shuo	Fang	USTC
Shusu	Shi	Central China Normal University
Sierra	Cantway	Yale University (US)
Sigurd	Nese	University of Oslo (NO)
Sijie	Zhang	Shandong University
Silvia	Masciocchi	GSI - Helmholtzzentrum fur Schwerionenforschung GmbH (DE)
Simon	Spies	Johann-Wolfgang-Goethe Univ. (DE)
Simon	Stendebach	Technische Universität Darmstadt
Skaydi	Grossberndt	Baruch College and Graduate Center, CUNY
Soeren	Schlichting	Bielefeld University
Somadutta	Bhatta	Stony Brook University (US)
Soohwan	Lee	Korea University (KR)
Sooraj Krishnan	Radhakrishnan	Kent State University
Soumik	Chandra	Purdue University (US)
Soumya	Mohapatra	Columbia University (US)
Sourav	Kundu	CERN
Sruthy Jyothi	Das	University of Illinois Chicago (US)
Stefan	Bathe	Baruch College, CUNY
Stefanie	Mrozinski	Frankfurt University
Stefano	Cannito	Universita e INFN Trieste (IT)
Steffen	Bass	Duke University
Su Houng	Lee	Yonsei University
Su-Jeong	Ji	Pusan National University (KR)
Subaru	Ito	University of Tsukuba (JP)
Subhadeep	Roy	IIT- Indian Institute of Technology (IN)
Subhash	Singha	Institute of Modern Physics CAS
Sukyung	Kim	Bergische Universtaet Wuppertal
Sunil	Jaiswal	Ohio State University
Suraj	Prasad	Indian Institute of Technology Indore (IN)
Susanne	Gläßel	Universität Frankfurt
Sushanta	Tripathy	CERN
Swati	Saha	National Institute of Science Education and Research (NISER) (IN)
Syed	Jahan	Wayne State University
Szabolcs	Borsányi	University of Wuppertal
Szymon	Harabasz	IJCLab Orsay
Taesoo	Song	GSI
Taku	Gunji	University of Tokyo (JP)
Tan	Lu	Institute of Modern Physics, Chinese Academy of Sciences
Tanu	Gahlaut	IIT- Indian Institute of Technology (IN)
Tapan	Nayak	CERN, Geneva and University of Houston
Tetyana	Galatyuk	GSI / TU Darmstadt
Thandar Zaw	Win	IIT Bhilai
Thiago	Siqueira Domingues	University of São Paulo
Thomas	Boettcher	Los Alamos National Laboratory (US)
Thomas	Marshall	UCLA
Thomas	Schaefer	North Carolina State University
Tim	Neidig	Goethe Universität Frankfurt am Main
Ting	Lin	Shandong University
Tom	Reichert	Frankfurt Institute for Advanced Studies (FIAS)
Tomas	Mari Surkau	CPHT, CNRS, École polytechnique, IP Paris
Tomasz	Bold	AGH University of Krakow (PL)
Tommaso	Isidori	The University of Kansas (US)
Tong	Fu	Shandong University
Tongzhou	Guo	Stony Brook University
Toshali	Mitra	ITP, Heidelberg
Trambak	Bhattacharyya	Jan Kochanowski University in Kielce
Tribhuban	Parida	IISER Berhampur
Tuba	Gundem	Goethe University Frankfurt (DE)
Tucker	Hwang	University of California Berkeley (US)
Tudor	Patuleanu	West University of Timișoara
Tuomas	Lappi	University of Jyväskylä
Tyler	Gorda	Goethe University Frankfurt
Ugo	Mire	JLU Giessen
Ulrich	Frankenfeld	GSI - Helmholtzzentrum fur Schwerionenforschung GmbH (DE)
Ulrich	Heinz	The Ohio State University
Uri	Sharell	University of Oxford
Urs Achim	Wiedemann	CERN
Uzair	Shah	Jan Kochanowski University (PL)
Valentina	Mantovani Sarti	Technische Universitaet Muenchen (DE)
Valeria Zelina	Reyna Ortiz	Jan Kochanowski University (PL)
Valerio	DI BELLA	Strasbourg-IPHC
Valeriya	Mykhaylova	Jagiellonian University in Kraków
Veronika	Barbasova	Pavol Jozef Safarik University (SK)
Veronika	Prozorova	Czech Technical University in Prague
Victor	Ambrus	West University of Timișoara
Victor	Gonzalez	Wayne State University (US)
Victor	Valencia Torres	Centre National de la Recherche Scientifique (FR)
Vincent	Kast	Goethe University Frankfurt (DE)
Vincenzo	Greco	University of Catania & INFN-LNS
Vincenzo	Nugara	University of Catania
Vinh Ba	Luong	Joint Institute for Nuclear Research
Vinícius	Franção	Institute of Physics - USP
Virginia	Bailey	Georgia State University
Vit	Kucera	Inha University (KR)
Volker	Friese	GSI Darmstadt
Volker	Koch	Lawrence Berkeley National Laboratory
Volodymyr	Chelnokov	Goethe University Frankfurt
Volodymyr	Kuznietsov	University of Houston
Volodymyr	Vovchenko	University of Houston
Vyshakh	B R	Tata Institute of Fundamental Research, Mumbai
Vértesi	Róbert	HUN-REN Wigner RCP
Víctor	López Pardo	Universidade de Santiago de Compostela
Wei	Li	Rice University (US)
Wei	Xie	Purdue University
Wei-Ping	Huang	Central China Normal University
Weiguang	Yuan	Tsinghua University
Weiyao	Ke	Central China Normal University
Wen-Hao	Zhou	Xi’an Aeronautical Institute
Wenbo	Dong	University of Science and Technology of China
Wenqing	Fan	University of Houston (US)
Wenya	Wu	Fudan University
Weronika	Stanek-Maslouska	Deutsches Elektronen-Synchrotron (DE)
Wilke	Van Der Schee	CERN / Utrecht University
William	Horowitz	University of Cape Town
Wit	Busza	Massachusetts Inst. of Technology (US)
Xialei	Jiang	Central China Normal University
Xiang-Yu	Wu	McGill University
Xianglei	Zhu	Tsinghua University (CN)
XIANGPAN	DUAN	Institute of Modern Physics, Fudan University
Xianwen	Bao	ShanDong University
Xiao	Huang	Rice University
Xiaofeng	Luo	Central China Normal University
Xiaojun	Yao	University of Washington
Xiaoyu	Liu	Rice University
Xiaozhi	Bai	University of Science and Technology of China (USTC)
Xiatong	Wu	UCLA
Xihe	Han	The Ohio State University
Xin	Dong	Lawrence Berkeley National Laboratory
Xin	Wu	University of Science and Technology of China
Xin-Nian	Wang	Central China Normal University
Xinbai	Li	University of Science and Technology of China
Xing	Wu	Central China Normal University
Xingrui	Gou	Shandong University
Xingyu	Guo	South China Normal Univeristy
Xinye	Peng	INFN Sezione di Padova
Xiongxiong	Xu	Tsinghua University
Xoán	Mayo López	Instituto Galego de Fïsica de Altas Enerxías - USC
Xu-Guang	Huang	Fudan University
Xudong	Yu	Peking University
Yannick	Söhngen	Physikalisches Intitut Heidelberg
Yannik	Hoffmann	Universität Bielefeld
Yash	Patley	Indian Institute of Technology Bombay
Yayun	He	South China University of Technology
Yen-Jie	Lee	Massachusetts Inst. of Technology (US)
Yeonju	Go	Brookhaven National Laboratory
Yi	Chen	Vanderbilt University (US)
Yi	Fang	Tsinghua University
Yi-Liang	Yin	University of Science and Technology of China
Yifei	Zhang	University of Science and Technology of China
Yige	Huang	Central China Normal University
Yiheng	Feng	复旦大学物理学系
Yiheng	Luo	Peking University
Yili	Wang	Peking University
yingjie	zhou	GSI
Yining	Gao	Fudan University
Yixuan	Jin	Central China Normal University
Yiyang	Peng	Institute of Theoretical Physics, Peking University
Yongcong	Xu	CCNU
You	Zhou	Niels Bohr Institute (DK)
Youen	Kang	Tsinghua University (CN)
Youquan	Qi	Central China Normal University
Youssef	El Mard	Goethe University Frankfurt (DE)
Yu	Zhang	Bielefeld University
Yu-Chen (Janice)	Chen	Massachusetts Institute of Technology
Yuan	Zhang	University of Science and Technology of China (CN)
Yuanjing	Ji	GSI - Helmholtzzentrum fur Schwerionenforschung GmbH (DE)
Yuanzhe	Wang	Fudan University (CN)
Yue Hang	Leung	University of Heidelberg
yuhei	morino	KEK
Yuki	Fujimoto	University of California, Berkeley
Yuko	Sekiguchi	RIKEN
Yuliia	Balkova	University of Silesia (PL)
Yumu	Yang	University of Illinois Urbana-Champaign
Yunpeng	Zheng	Fudan university
YUNSHAN	CHENG	UCLA
Yunxin	Ye	Jena University
Yushan	Mu	Fudan University
Yuuka	Kanakubo	RIKEN iTHEMS / Lawrence Berkeley National Laboratory
Zachary	Akridge	Indiana University
Zachary	Sweger	University of California, Davis
Zaiba	Mushtaq	Institute of Modern Physics, CAS/University of Chinese Academy of Sciences, Beijing China
Zaining	Wang	Fudan University
Zbigniew	Drogosz	Jagiellonian University
Zebo	Tang	University of Science and Technology of China (CN)
Zhen	Zhang	Central China Normal University CCNU (CN)
Zhengchen	Lian	Tsinghua University (CN)
Zhengqing	Wang	Fudan University (CN)
Zhengxi	Yan	Stony Brook University
Zhenjun	Xiong	University of Science and Technology of China (CN)
Zhenyu	Chen	Shandong University (CN)
Zhiwan	Xu	Los Alamos National Laboratory
Zhiyong	Lu	China Institute of Atomic Energy (CN)
Zhong-Hua	Zhang	Fudan University
Zhuoheng	Yang	Stony Brook University
ZiHao	Guo	Institute of Modern Physics, Fudan University
zilin	yuan	University of Chinese Academy of Sciences,China
Ziyang	Li	University of Science and Technology of China
Ziyue	Xiang	Central China Normal University
Zoltan	Varga	Yale University
Zuowen	Liu	Central China Normal University
Zuzana	Paulinyova	Pavol Jozef Safarik University (SK)
Zuzanna Anna	Chochulska	Czech Technical University (CZ), Warsaw University of Technology (PL)
