First Name	Last Name	Affiliation
Aaron	Capon	Stefan Meyer Institute for Subatomic Physics (SMI), Austrian Academy of Sciences (AT)
Abhijit	Majumder	Wayne State University
Adam	Bzdak	AGH University of Science and Technology
Adam	Kisiel	JINR/Warsaw University of Technology (PL)
Adam	Takacs	University of Bergen
Adrian	Rodriguez	Goethe University Frankfurt am Main
Adrian Amatus	Weber	JLU Gießen
Adrian Fereydon	Nassirpour	Lund University (SE)
Agnieszka	Wergieluk	University of California, Los Angeles
Ahsan Mehmood	Khan	Central China Normal University CCNU (CN)
Aihong	Tang	Brookhaven National Laboratory
Ailec de la Caridad	Bell Hechavarria	Westfaelische Wilhelms-Universitaet Muenster (DE)
Akihiko	Monnai	High Energy Accelerator Research Organization (KEK)
Aleksas	Mazeliauskas	Heidelberg University/ CERN
Alessandro	De Falco	Universita e INFN, Cagliari (IT)
Alessandro	Grelli	Utrecht University (NL)
Alexander	Milov	Weizmann Institute of Science (IL)
Alexander	Rothkopf	University of Stavanger
Alexander Philipp	Kalweit	CERN
Alexandra	Neagu	University of Oslo (NO)
Alexandre	Lebedev	Iowa State University (US)
Alexandru	Parvan	Joint Institute for Nuclear Research
Alexandru Florin	Dobrin	Institute of Space Science (RO)
Alina	Czajka	National Centre for Nuclear Research
Alwina	Liu	University of California Berkeley (US)
Amaresh	Jaiswal	National Institute of Science Education and Research
Amit	Kumar	Wayne State University
Anar	Rustamov	GSI/National Nuclear Research Center (AZ)
Andre Govinda	Stahl Leiton	Rice University (US)
Andrea	Dainese	INFN - Padova
Andrea	Danu	Institute of Space Science (RO)
Andrea	Dubla	GSI
Andrea	Rossi	Universita e INFN, Padova (IT)
Andreas	Ipp	TU Wien
Andreas	Morsch	CERN
Andrey	Seryakov	St Petersburg State University (RU)
Angela	Badala	INFN - Sezione di Catania
Angelika Magdalena	Tefelska	Warsaw University of Technology (PL)
Anjali	Sharma	Panjab University (IN)
Anke	Lei	Wuhan University of Technology
Anna	Schäfer	Frankfurt Institute for Advanced Studies (FIAS)
Anne Marie	Sickles	Univ. Illinois at Urbana Champaign (US)
Anping	Huang	Indiana University
Anthony	Frawley	Florda State University
Anthony	Hodges	Georgia State University
Anton	Lymanets	GSI - Helmholtzzentrum fur Schwerionenforschung GmbH (DE)
Anton	Motornenko	Frankfurt Institute for Advanced Studies
Antonio	Ortiz Velasquez	Universidad Nacional Autonoma (MX)
Anurag	Tiwari	Tata Institute of Fundamental Research
Ao	Luo	CCNU
Arabinda	Behera	Stony Brook Universty (US)
Aradhya	Shukla	School of Physics and Astronomy, Sun Yat-Sen University, Guangzhou, China
Arghya	Chatterjee	Central China Normal University
Arthur	Gal	Centre National de la Recherche Scientifique (FR)
Arvind	Khuntia	IFJ PAN
Ashish	Pandav	National Institute of Science Education and Research, Bhubaneswar
Attila	Pasztor	Eötvös University
Austin Alan	Baty	Rice University (US)
Axel	Drees	Stony Brook University
Ayaka	Suzuki	Nara Women's University
Azumi	Sakai	Sophia University
Azwinndini	Muronga	Nelson Mandela University
Baidyanath	Sahoo	IIT- Indian Institute of Technology (IN) Bombay
Baochi	Fu	Peking University
Barbara	Jacak	University of California Berkeley (US)
Barbara	Trzeciak	Czech Technical University in Prague
Bedangadas	Mohanty	National Institute of Science Education and Research (IN)
Ben-Wei	Zhang	Central China Normal University
Benjamin	Audurier	Universita e INFN, Cagliari (IT)
Benjamin	Doenigus	Johann-Wolfgang-Goethe Univ. (DE)
Benjamin	Schweid	Stony Brook University
Benjamin	Schüller	Goethe-Universität Frankfurt
Berndt	Mueller	Brookhaven National Laboratory
Biao	Zhang	Central China Normal University CCNU (CN)
Bing-feng	JIANG	Hubei Minzu University
Bjoern	Schenke	Brookhaven National Lab
Bojana	Ilic	Institute of Physics Belgrade
Boleslaw	Wyslouch	Massachusetts Inst. of Technology (US)
Bong-Hwi	Lim	Pusan National University (KR)
Borge	Nielsen	University of Copenhagen (DK)
Boris	Hippolyte	IPHC / USIAS (Strasbourg, FR)
Boris	Tomasik	Czech Technical University
Bowen	Xiao	Central China Normal University
Brett	Fadem	Muhlenberg College
Brian	Cole	Columbia University (US)
Caio	A. G. Prado	Central China Normal University (CN)
Caio	Brito	Universidade Federal Fluminense
Cameron	Dean	Los Alamos National Laboratory (US)
Carlos A.	Salgado	IGFAE - Universidade de Santiago de Compostela
Carsten	Greiner	University of Frankfurt
Catalin	Ristea	Institute of Space Science (RO)
Cesar	Bernardes	UNESP - Universidade Estadual Paulista (BR)
changfeng	li	Shandong University
ChanJui	Feng	National Cheng Kung University
Chanwook	Park	McGill University
Chao	Guo	Central China Normal University CCNU (CN)
Charles	Gale	McGill University
Chathuranga	Sirimanna	Wayne State University
Cheng	Zhang	Key Laboratory of Particle Physics and Particle Irradiation (MOE), Institute of frontier and interdisciplinary science, Shandong University & Key Laboratory of Quark and Lepton Physics (MOE) and Institute of Particle Physics, Central China Normal University
Chenlu	Hu	Institute of Modern Physics, Chinese Academy of Sciences
Chi	Ding	Central China Normal University
Chi	Yang	Shandong University
Chihiro	Sasaki	University of Wroclaw
Chowdhury	Aminul Islam	University of Chinese Academy of Sciences
Christian	Fischer	JLU Gießen
Christian	Fischer	University of Giessen
Christoph	Blume	Johann-Wolfgang-Goethe Univ. (DE)
Christopher	Mc Ginn	University of Colorado Boulder (US)
Christopher	Plumberg	Lund University
Chuan	Sun	Shandong University
Chun	Shen	Wayne State University
Chunjian	Zhang	Shanghai Institute of Applied Physics
Cindy	Mordasini	Technische Universitaet Muenchen (DE)
cong	li	Shandong University
Constantin	Loizides	ORNL
Cristina	Terrevoli	University of Houston (US)
Daicui	Zhou	Central China Normal University CCNU (CN)
Daiki	Sekihata	University of Tokyo (JP)
Daiki	Suenaga	Central China Normal University
daimei	zhou	CCNU,CHINA
Daniel	Brandenburg	Brookhaven National Laboratory
Daniel	Pablos	University of Bergen
David	Coelho	Student
David	Morrison	BNL
David	Stewart	Yale University
De-Xian	Wei	Guangxi University of Science and Technology
Debasish	Mallick	National Institute of Science Education and Research
Deepa	Thomas	University of Texas at Austin (US)
Defu	Hou	Central China Normal University
Denes	Molnar	Purdue University
deng	wan	Guizhou University of Finance and Economics
Dennis	Bollweg	Bielefeld University
Dennis	Perepelitsa	University of Colorado Boulder
Derek	Teaney	Stony Brook University
Dhananjaya	Thakur	Indian Institute of Technology Indore (IN)
Di	Yang	Tsinghua University (CN)
Dieter	Roehrich	University of Bergen (NO)
Dimitar Lubomirov	Mihaylov	Technische Universitaet Muenchen (DE)
Dimitra	Andreou	CERN, Nikhef National institute for subatomic physics (NL)
DING	CHEN	UNIVERSITY OF CALIFORNIA, RIVERSIDE
dingwei	zhang	CCNU
Dirk	Rischke	University Frankfurt
Dmitri	Kharzeev	Stony Brook U. and BNL
Dmitrii	Dementev	JINR LHEP
Dmitry	Sosnov	NRC Kurchatov Institute PNPI (RU)
Dmytro	Oliinychenko	Lawrence Berkeley National Laboratory
Dominik Karol	Derendarz	Polish Academy of Sciences (PL)
Dominique	Dittert	TU Darmstadt
Dong Jo	Kim	University of Jyvaskyla (FI)
Dongdong	hu	USTC/IMP
Dongfang	Wang	Shanghai Inst. of Applied Physics Chinese Academy of Science (
Douglas	Wertepny	Ben Gurion University of the Negev
Dukhishyam	Mallick	National Institute of Science Education and Research (IN)
Dusan	Zigic	Institute of Physics Belgrade
Duxin	Zheng	Shandong University
Dániel	Kincses	Eötvös Loránd University
Edmond	Iancu	Institut de Physique Théorique de Saclay
Eduardo	Grossi	Heidelberg University
Edward	Shuryak	Stony Brook University
Eero Aleksi	Kurkela	CERN and Univ. Stavanger
Ejiro Naomi	Umaka	University of Houston (US)
Elisa	Meninno	Stefan Meyer Institute for Subatomic Physics (SMI)
Enrico	Scomparin	INFN Torino (IT)
Enrico	Speranza	Goethe University Frankfurt
Esther	Bartsch	Johann-Wolfgang-Goethe Univ. (DE)
Evgeny	Kashirin	National Research Nuclear University MEPhI (RU)
Evgeny	Zabrodin	University of Oslo (NO)
Fan	Si	USTC
Farid	Taghinavaz	IPM
Federico	Antinori	Universita e INFN, Padova (IT)
Fei	Sun	China Three Gorges University
Felipe Andres	Garcia Rosales	Centre National de la Recherche Scientifique (FR)
Felix	Reidt	CERN
Felix	Ringer	UC Berkeley/LBNL
Feng	Li	Lan Zhou University
Feng	Liu	Central China Normal University
Feng-lei	Liu	CCNU
fenglan	shao	Qufu Normal University
Fengxian	Liu	China University of Geosciences
Fernando	Torales Acosta	Lawrence Berkeley National Lab. (US)
Fernando Antonio	Flor	University of Houston (US)
Filip	Erhardt	University of Zagreb (HR)
Flemming	Videbaek	Brookhaven National Laboratory
Florian	Cougoulic	The Ohio State University
Florian	Seck	TU Darmstadt
Francesco	Becattini	Unversity of Florence
Frank	Geurts	Rice University (US)
Frederique	Grassi	Universidade de São Paulo-Brazil
Freja	Thoresen	University of Copenhagen (DK)
Frithjof	Karsch	Bielefeld University
fu	chuan	central china normal university
Fu-Hu	Liu	Shanxi University
Fuqiang	Wang	Purdue University (US)
Gabor	David	Brookhaven National Laboratory
Gabriel	Denicol	Universidade Federal Fluminense
Gang	Chen	China University of Geosciences
Gang	Wang	UCLA
Gaoqing	Cao	Sun Yat-sen University
Georgios	Krintiras	The University of Kansas (US)
Gergely Gabor	Barnafoldi	Wigner RCP Hungarian Academy of Sciences (HU)
gezheng	zhou	sysu
Gian Michele	Innocenti	CERN
Gianluca	Usai	University and INFN, Cagliari (IT)
Gojko	Vujanovic	Wayne State University
Gokce	Basar	University of North Carolina, Chapel Hill
Gongming	Yu	Institute of Modern Physics, Chinese academy of sciences
Govert	Nijs	Utrecht University
Grecia	Castelazo Martinez	Massachusetts Inst. of Technology (US)
Greg	Jackson	University of Bern
Grzegorz	Stefanek	Jan Kochanowski University (PL)
Guang-You	Qin	Central China Normal University
Gunther	Roland	Massachusetts Inst. of Technology (US)
Guo-yun	Shao	Xi'an Jiaotong university
Guojun	Huang	Tsinghua University
Guruprasad	Kadam	Shivaji University
Guy	Paic	Universidad Nacional Autonoma (MX)
Gwang-Jun	Kim	Massachusetts Inst. of Technology (US)
Gyeonghwan	Bak	Chonnam National University (KR)
Gábor	Bíró	Wigner RCP
Gábor	Papp	Eötvös Loránd University
Haavard	Helstrup	Western Norway University of Applied Sciences (NO)
Hai	Wang	SINAP
Hannah	Elfner	GSI/Frankfurt University/FIAS
Hanseul	Lee	Chonnam National University (KR)
Hanzhong	Zhang	Central China Normal University
Hao	Qiu	Institute of Modern Physics, CAS
Hao-Lei	Chen	Fudan University
Haohao	Peng	USTC
Haojie	Xu	Huzhou University
Harald	Appelshaeuser	Johann-Wolfgang-Goethe Univ. (DE)
Harsimranjeet	Singh	University of jammu
Hayato	Aoi	Tokyo University of Science
He-Xia	Zhang	Central China Normal University
Helen	Caines	Yale University (US)
Hendrik	Roch	University Bielefeld
Heng	Miao	Central China Normal University
Heng-Tong	Ding	Central China Normal University
Hengne	Li	South China Normal University (CN)
Henner	Buesching	Johann-Wolfgang-Goethe Univ. (DE)
Henrique Jose	Correia Zanoli	Utrecht University
Henry	Klest	Stony Brook University
Hermann	Franz Degenhardt	Universidade de Sao Paulo (BR)
Hideki	Hamagaki	Nagasaki Inst. of Applied Science (JP)
Hideki	Okawa	Fudan University
Hidetoshi	Taya	Fudan University
Hirotsugu	Fujii	University of Tokyo
Hiroyuki	Sako	Japan Atomic Energy Agency (JP)
Hong-Zhong	Wu	University of Science and Technology of China
Hongxi	Xing	South China Normal University
Horst	Stoecker	GSi
Horst Sebastian	Scheid	Johann-Wolfgang-Goethe Univ. (DE)
Hua	Pei	Central China Normal University CCNU (CN)
Huan	Chen	China University of Geosciences (Wuhan)
huan zhong	huang	UCLA
Hui	Li	Fudan University
Hui	Liu	CCNU
Hui	Liu	Institute of Modern Physics, Chinese Academy of Sciences
Hui	Zhang	South China Normal University
Hyunchul	Kim	Chonnam National University (KR)
Ian Gardner	Bearden	University of Copenhagen (DK)
Ievgenii	Kres	University of Wuppertal
Ilya	Selyuzhenkov	GSI / EMMI / MEPhI
In Kwon	Yoo	Pusan National University (KR)
Ingo Martin	Deppner	Physikalisches Institut der Universität Heidelberg
Ionut Cristian	Arsene	University of Oslo (NO)
Irfan	Siddique	USTC
ismail	soudi	university of Bielefeld
Itzhak	Tserruya	Weizmann Institute of Science (IL)
Iurii	Mitrankov	Peter the Great St. Petersburg University, St. Petersburg, 195251 Russia
Ivan	Vitev	LANL
Ivan	Vorobyev	Technische Universitaet Muenchen (DE)
Jaebeom	Park	Korea University (KR)
Jagbir	Singh	Panjab University
Jakub	Cimerman	Faculty of Nuclear Sciences and Physical Engineering, Czech Technical University
Jakub	Kvapil	University of Birmingham (GB)
Jamal	Jalilian-Marian	Baruch College, CUNY
James	Dunlop	Brookhaven National Laboratory
James Lawrence	Nagle	University of Colorado Boulder
Jamie	Stafford	University of Houston
Jan	Fotakis	Goethe-University Frankfurt am Main
Jan	Hammelmann	Frankfurt University of Advanced Studies
Jan	Otto	JLU Giessen
Jan	Steinheimer	FIAS
Jan	Vanek	Nuclear Physics Institute, Czech Academy of Sciences
Jan M.	Pawlowski	University of Heidelberg
Jana	Crkovska	Los Alamos National Laboratory (US)
Jana N.	Guenther	University of Regensburg
Jarkko	Peuron	ECT*
Jarkko	Peuron	FBK - Fondazione Bruno Kessler (IT)
Jasmine	Brewer	Massachusetts Institute of Technology
Jasper	Parkkila	University of Jyvaskyla (FI)
Jean-Bernard	Rose	Frankfurt Institute for Advanced Studies
Jean-Francois	Paquet	Duke University
Jean-Paul	Blaizot	CNRS
Jean-Yves	Ollitrault	CNRS
Jens-Jorgen	Gaardhoeje	University of Copenhagen (DK)
Jeongsu	Bok	Inha University (KR)
Jerome	Jung	Johann-Wolfgang-Goethe Univ. (DE)
Jessica	Churchill	McGill University
Jhuma	Ghosh	Saha Institute of Nuclear Physics (IN), HBNI
Ji-Chong	Yang	Liaoning Normal University
Jia	Chen	Shandong University
Jian	Deng	Shandong University
Jian	Zhou	USTC
Jian-Hua	Gao	Shandong University at Weihai
Jiangyong	Jia	Stony brook Universty (US)
Jianhui	Zhu	GSI (DE) & CCNU (CN)
Jianing	Li	Tsinghua University
Jianqiao	Wang	Tsinghua University (CN)
jiaxing	zhao	Tsinghua University
Jiayin	Sun	Tsinghua University
Jiayu	Wu	Guizhou University
Jie	Zhao	Purdue University
Jihye	Song	University of Houston (US)
Jim	Thomas	The National Science Foundation
jin	gui	tsinghua university
Jin	Hu	Tsinghua University
Jin	Huang	Brookhaven National Lab
Jin	Wu	Central China Normal University
Jin Joo	Seo	Inha University (KR)
Jinfeng	Liao	Indiana University
Jing	Wang	Massachusetts Inst. of Technology (US)
Jing	Zhang	CCNU
Jinghua	Fu	ccnu
Jingyi	Chao	Institute of Modern Physics, CAS
Jinjin	Pan	Wayne State University (US)
Jishnu	Goswami	Bielefeld University
Joachim	Stroth	Johann-Wolfgang-Goethe Univ. (DE)
Joel Anthony	Mazer	Rutgers University
Johanna	Stachel	Ruprecht Karls Universitaet Heidelberg (DE)
John	Lajoie	Iowa State University
John William	Harris	Yale University (US)
Jonatan	Adolfsson	Lund University (SE)
Jonathan	Runchey	Iowa State University
Jonghan	Park	Inha University (KR)
Jorge	Noronha	University of Illinois at Urbana-Champaign
Joseph	Adams	Ohio State University
Jovan	Milosevic	University of Belgrade (RS)
Julia	Velkovska	Vanderbilt University (US)
Jun	Xu	Shanghai Advanced Research Institute, CAS
Junjie	He	Shanghai Institute of Applied Physics, Chinese Academy of Sciences
Junjie	ZHANG	USTC
Junlee	Kim	Chonbuk National University (KR)
Jurgen	Schukraft	University of Copenhagen (DK)
Jussi	Viinikainen	University of Illinois at Chicago (US)
Justin	Mohs	FIAS, GSI, Frankfurt University
Kaede	Kamano	Nara Women's University (JP)
Kai	Zhou	FIAS, Goethe-University Frankfurt am Main
KaiJia	Sun	Texas A&M University
Karoly	Uermoessy	IHEP Chinese Academy of Sciences (CN)
Katarina	Krizkova Gajdosova	Czech Technical University (CZ)
Kaya	Tatar	Massachusetts Inst. of Technology (US)
Kayman	Gonçalves	IFGW
ke	mi	Central China Normal University
Keming	Shen	School of Science, East China University of Technology
Kenichi	Tadokoro	University of Tsukuba (JP)
Kenji	Fukushima	The University of Tokyo
Kenshi	Kuroki	Sophia University
Kenta	Shigaki	Hiroshima University (JP)
Kentaro	Nishimura	Keio University
Kie Sang	Jeong	Institute for Nuclear Theory
Kirill	Lapidus	CERN
Kishora	Nayak	Central China Normal University, China
Klaudia	Maj	AGH University of Science and Technology (PL)
Koichi	Murase	Peking University
Konrad	Tywoniuk	University of Bergen (NO)
Kosuke	Okubo	University of Tsukuba
Kouki	Nakamura	Nagoya University
Kousik	Naskar	Bhabha Atomic Research Centre (IN)
Krishna	Rajagopal	Massachusetts Inst. of Technology (US)
Krista	Smith	Florida State University
Kristjan	Gulbrandsen	University of Copenhagen (DK)
Krzysztof	Redlich	University of Wroclaw (PL)
Kun	Jiang	University of Science and Technology of China
Kurt Keys	Hill	University of Colorado Boulder (US)
Langtian	Liu	Peking University
Lanlan	Gao	Fudan University
Larisa	Bravina	University of Oslo (NO)
Larry	McLerran	INT, University of Washington
Laszlo Pal	Csernai	University of Bergen
Laura	Fabbietti	Technische Universitaet Muenchen (DE)
Laura Brittany	Havener	Yale University (US)
le	zhang	Hubei Normal University
Lei	Wang	Central China Normal University
Lei	Yin	South China Normal University, IQM
Leif	Lönnblad	Lund University (SE)
Leonhardt Heinrich	Viebach	Johann-Wolfgang-Goethe Univ. (DE)
Leszek	Kosarzewski	Czech Technical University in Prague
Li	Yan	Fudan University
Liang	Zheng	China University of Geosciences (Wuhan)
Lianyi	He	Department of Physics, Tsinghua University
Lihan	Liu	Vanderbilt University (US)
Lijuan	Ruan	Brookhaven National Laboratory
lijuan	zhou	Guangxi University of Science and Technology
Liliana	Apolinario	LIP (PT)
Lilin	Zhu	Sichuan University
Lin	Chen	Central China Normal University
Ling	Huang	Shanghai Institute of Applied Physics
Lingfeng	Chen	Peking University
Lingxiao	Wang	Tsinghua University/University of Tokyo
Lipei	Du	The Ohio State University
liqiang	zhu	CCNU
Liuyao	Zhang	Shanghai institute of applied physics , CAS
Livio	Bianchi	Universita e INFN Torino (IT)
Lixin	Yang	Sun Yat-sen University
Lokesh	Kumar	Panjab University (IN)
Long	Ma	Fudan University
Long-Gang	Pang	CCNU
Luca	Barioglio	Universita e INFN Torino (IT)
Luca	Micheletti	Universita e INFN Torino (IT)
Lucas	Altenkamper	University of Bergen (NO)
Lucia	Oliva	Institute for Theoretical Physics (ITP), Frankfurt am Main
Lucia Anna	Husova	Westfälische-Wilhelms Universität Münster (DE)
Luciano	Musa	CERN
Luciano	Rezzolla	Institute for Theoretical Physics
Lukas	Kramarik	Czech Technical University (CZ)
Lukas	Kreis	GSI - Helmholtzzentrum für Schwerionenforschung GmbH
Ma	Guo-Liang	Fudan University
Maciej	Rybczynski	Jan Kochanowski University (PL)
Magdalena	Djordjevic	Institute of Physics Belgrade
Maitreyee	Mukherjee	Central China Normal University CCNU (CN)
Maja Katarzyna	Mackowiak-Pawlowska	Warsaw University of Technology (PL)
Mamiya	Kawaguchi	Fudan University
man	xie	Central China Normal University
mao	shijun	Xi'an Jiaotong University
Maowu	Nie	Shandong University (SDU)
Marc	Borrell Martinez	University of Bielefeld
Marcel	Lesch	Technische Universitaet Muenchen (DE)
Marco	Van Leeuwen	Nikhef National institute for subatomic physics (NL)
Maria	Sergeeva	UCLA
Maria Paola	Lombardo	INFN
Martin	Rybar	Columbia University (US)
Martin	Spousta	Charles University
Masahiro	Takamura	University of Tsukuba(JP)
Masakiyo	Kitazawa	Osaka University
Masayuki	Asakawa	Osaka University
Matt	Durham	Los Alamos National Laboratory
Matthew	Kelsey	Lawrence Berkeley National Lab
Matthew	Luzum	University of Sao Paulo
Matthew	Nickel	The University of Kansas (US)
Matthew	Sievert	University of Illinois
Matthias	Kaminski	University of Alabama, Tuscaloosa
Mattia	Faggin	Universita e INFN, Padova (IT)
Mauricio	Hippert	Universidade Estadual de Campinas
Maximiliano	Puccio	CERN
Megan	Connors	Georgia State University and RBRC
Meng	Zhou	Peking University
Mengke	Cai	Central China Normal University CCNU (CN)
Mengquan	Yang	Central China Normal University
Mesut	Arslandok	Ruprecht Karls Universitaet Heidelberg (DE)
Michael	Phipps	Univ. Illinois at Urbana Champaign (US)
Michael	Weber	Stefan Meyer Institute for Subatomic Physics (SMI), Austrian Academy of Sciences (AT)
Michael Florian	Wondrak	Frankfurt Institute for Advanced Studies (FIAS)
Michael Joseph	Peters	Massachusetts Inst. of Technology (US)
Mihaela Gabriela	Besoiu	Institute of Space Science (RO)
Mike	Lisa	Ohio State University (US)
Mike Henry Petrus	Sas	Nikhef National institute for subatomic physics (NL)
Miklos	Gyulassy	Columbia U, LBNL, CCNU,Wigner
Miklós	Horváth	CCNU IoPP, Wuhan
Min	He	Nanjing University of Science & Technology
Ming	Li	Peking University
Ming	Shao	Univ. of Sci. and Tech. of China
Ming Xiong	Liu	Los Alamos National Laboratory
Mingrui	Zhao	China Institute of Atomic Energy (CN)
Misha	Stephanov	UIC
Mohammad	Nasim	IISER Berhampur
Molly	Taylor	Massachusetts Inst. of Technology (US)
Mubarak	Alqahtani	Imam Abdulrahman Bin Faisal University
Muhammad Usman	Ashraf	CCNU/Tsinghua University
Muhammed Ikram	Shahzad	COMSATS University Islamabad (PK)
Mustafa	Anaam	Central China Normal University CCNU (CN)
Nadia	Barnard	University of Cape Town
Najmul	Haque	NISER, India
Nicole	Apadula	Lawrence Berkeley National Lab. (US)
Nicole	Bastid	LPC/UCA Clermont-Ferrand (France)
NIHAR RANJAN	Sahoo	Shandong University
Niklas	Mueller	Brookhaven National Laboratory
Nikolay	Geraksiev	Plovdiv University Paisii Hilendarski, Joint Institute for Nuclear Research
Nikolay	Karpushkin	Russian Academy of Sciences (RU)
Nima	Zardoshti	CERN
Nina	Kersting	Bielefeld University
Ning	Yu	Xinyang Normal University
NingBo	Chang	Xinyang Normal University
Niseem	Abdelrahman	University of Illinois at Chicago
Nora	Weickgenannt	Goethe University Frankfurt
Norbert	Novitzky	University of Tsukuba (JP)
Norbert Willi	Herrmann	Ruprecht Karls Universitaet Heidelberg (DE)
Nu	Xu	Central China Normal University / LBNL
Olaf	Kaczmarek	University of Bielefeld
Oleg	Golosov	MEPhI (RU)
Oleksandr	Vitiuk	Taras Shevchenko National University of Kyiv and Uniersity of Oslo
Olga	Evdokimov	University of Illinois at Chicago (US)
Oliver	Matonoha	Lund University (SE)
Omar	Vazquez Rueda	Lund University (SE)
Oskari Antti Matti	Saarimaki	Helsinki Institute of Physics (FI)
Osnan	Maragoto Rodriguez	Goethe University Frankfurt am Main
Panos	Christakoglou	Nikhef National institute for subatomic physics (NL)
Paolo	Parotto	University of Wuppertal
Pasquale	Di Nezza	INFN e Laboratori Nazionali di Frascati (IT)
Patrick	Huhn	Johann-Wolfgang-Goethe Univ. (DE)
Patrick	Pfistner	KIT
Paul	Caucal	IPhT
Paula	Hillmann	Frankfurt Institute for Advanced Studies
Pavel	Larionov	INFN e Laboratori Nazionali di Frascati (IT)
Peifeng	Liu	Stony Brook University
Peng	Liu	Shanghai Institute of Applied Physics, Chinese Academy of Sciences
Peng	Ru	South China Normal University
Pengfei	Wang	USTC/BNL
Pengqi	Yin	Columbia University (US)
Pengyao	Cui	Central China Normal University CCNU (CN)
Pengyu	Ren	Shanghai Institute of Applied Physics, Chinese Academy of Science
Peter	Braun-Munzinger	GSI - Helmholtzzentrum fur Schwerionenforschung GmbH (DE)
Peter	Christiansen	Lund University (SE)
Peter	Senger	CCNU
Peter Alan	Steinberg	Brookhaven National Laboratory (US)
Peter Martin	Jacobs	Lawrence Berkeley National Lab. (US)
Petja	Paakkinen	Universidade de Santiago de Compostela
Philipp	Gubler	JAEA
Pierre	Moreau	Duke University
Pierre-Alain	Loizeau	GSI - Helmholtzzentrum fur Schwerionenforschung GmbH (DE)
Prabhakar	Palni	AGH University of Science and Technology (PL)
Pragya	Singh	University of Bielefeld
Prakhar	Garg	Stony Brook University, NY, USA
Prashant Kumar	Srivastava	Indian Institute of Technology Ropar
Prithwish	Tribedy	Brookhaven National Lab
Qian	Chen	Shanghai Institute of Applied Physics
Qian	Yang	Shandong University
Qiang	Hu	Institute of Modern Physics,CAS
Qiao	Xu	Vanderbilt University (US)
Qing	Zhang	CCNU
Qingfei	Han	CCNU
Qiye	Shou	Fudan University
Qun	Wang	University of Science and Technology of China
Raghav	Kunnawalkam Elayavalli	Wayne State University
Raghunath	Sahoo	Indian Institute of Technology Indore (IN)
Raimond	Snellings	Nikhef National institute for subatomic physics (NL)
Rainer	Fries	Texas A&M University
Raju	Venugopalan	Brookhaven National Laboratory
Ralf	Averbeck	GSI - Helmholtzzentrum für Schwerionenforschung GmbH (DE)
Ralf-Arno	Tripolt	Goethe University Frankfurt
Ran	Bi	Massachusetts Inst. of Technology (US)
Ran	Xu	Central China Normal University CCNU (CN)
Randhir	Singh	University of Jammu (IN)
Ranjit	Nayak	IIT- Indian Institute of Technology (IN)
Rashmi	Raniwala	University of Rajasthan (IN)
Rasmus	Larsen	Brookhaven National Laboratory
Rene	Bellwied	University of Houston (US)
Renjie	Wang	University of Science and Technology of China
Renu	Bala	University of Jammu (IN)
Richard	Lednicky	Joint Institute for Nuclear Research, Dubna, Russia
Rishi	Sharma	TIFR
Rob	Pisarski	Brookhaven National Lab.
Robert	Greifenhagen	HZDR
Roberta	Arnaldi	INFN Torino (IT)
Roman	Zhokhov	IHEP
Ron	Soltz	Lawrence Livermore Nat. Laboratory (US)
Rongrong	Ma	BNL
Rosi	Reed	Lehigh University
Roy	Lacey	Stony Brook University
Ruben	Kara	University of Wuppertal
Ruiqin	Wang	Qufu Normal University
RURI	OTSUKA	Sophia Univ.
Rutuparna	Rath	Indian Institute of Technology Indore (IN)
Sa	WANG	Central China Normal University
Saehanseul	Oh	Yale University - BNL
Samuel	Belin	Universita e INFN, Cagliari (IT)
Sandeep	Chatterjee	IISER, Berhampur
Sandra	Padula	UNESP - Universidade Estadual Paulista (BR)
Sanghoon	Lim	Pusan National University (KR)
Sangyong	Jeon	McGill University
Sarah	Porteboeuf	Université Clermont Auvergne (FR)
Satoshi	Yano	Université Paris-Saclay (FR)
Sebastian	Tapia Araya	Univ. Illinois at Urbana Champaign (US)
Sergei	Voloshin	Wayne State University (US)
Seyed Farid	Taghavi	Technische Universitaet Muenchen (DE)
Seyoung	Han	Korea University
Shahin	Iqbal	Institute of Particle Physics, CCNU
Shaifali	Mehta	Physikalisches Institut - Eberhard Karls Universität Tübingen
Shaista	Khan	Aligarh Muslim University (IN)
Shan-Liang	Zhang	Central China Normal University
Shangxing	Li	CCNU
shanjin	wu	Peking University
Shanshan	Cao	Wayne State University
Shanzhen	Chen	Universita e INFN, Cagliari (IT)
Shaowei	Lan	Central China Normal University
Sheng-Qin	Feng	China Three Gorges University
Shengli	Huang	Stony Brook University
Shengquan	Tuo	Vanderbilt University (US)
Shengtai	Li	Institute of Modern Physics & CCNU
Shi	Pu	University of Science and Technology of China
Shi	Pu	USTC
Shi-Yong	Chen	CCNU
Shile	Chen	Department of physics, Tsinghua University
Shingo	Sakai	University of Tsukuba (JP)
Shinichi	Esumi	University of Tsukuba (JP)
Shinichi	Hayashi	University of Tokyo (JP)
Shiori	Kajimoto	Osaka University
Shiyi	Zhang	GuiZhou University
Shiyong	Li	University of illinois at chicago
Shizheng	Yang	Shandong University
Shota	Imaki	The University of Tokyo
Shreyansh Shankar	Dave	The Institute of Mathematical Sciences, Chennai, India
Shu	HE	Central China Normal University
Shuai	Liu	Texas A&M University
Shuai	Wang	FuDan University
Shuang	Li	China Three Gorges University
Shuqing	Li	Jining University
Shusu	Shi	Central China Normal University
Shuwan	Shen	Central China Normal Univercity
shuxiang	ma	shandong University
Shuzhe	SHI	McGill University
Shyam	Kumar	Institute of Modern Physics, Chinese Academy of Sciences
Sigtryggur	Hauksson	McGill University
Silvia	Masciocchi	GSI - Helmholtzzentrum fur Schwerionenforschung GmbH (DE)
Silvia	Pisano	Centro Fermi & Laboratori Nazionali di Frascati - INFN (IT)
Sitian	Qian	Peking University
Siyu	Tang	Central China Normal University CCNU (CN) and LPC Clermont-Ferrand
Sizar	Aziz	Centre National de la Recherche Scientifique (FR)
Soeren	Schlichting	Universität Bielefeld
Somadutta	Bhatta	Stony brook Universty (US)
Somnath	Kar	Central China Normal University CCNU (CN)
Song	Shi	National University of Defense Technology
Song	Zhang	Fudan University (CN)
Songkyo	Lee	Iowa State University (US)
Sonja	Kabana	Centre National de la Recherche Scientifique (FR)
Sooraj Krishnan	Radhakrishnan	Lawrence Berkeley National Laboratory
sora	oh	chonbuk national university
Soumya	Mohapatra	Columbia University (US)
Sourav	Kundu	National Institute of Science Education and Research (IN)
Sourendu	Gupta	TIFR
Souvik Priyam	Adhya	Charles University
Stefan	Floerchinger	Heidelberg University
Stefano	Trogolo	Universita e INFN, Padova (IT)
Steffen A.	Bass	Duke University
Subhash	Singha	Institute of Modern Physics CAS
SUBHASIS	SAMANTA	National Institute of Science Education and Research
Subikash	Choudhury	Fudan University, UCLA
Subrata	Pal	Tata Institute, Mumbai
Sudhir	Raniwala	University of Rajasthan (IN)
Sudhir Pandurang	Rode	Indian Institute of Technology Indore (IN)
Sumit Kumar	Saha	VECC
Sunil	Jaiswal	Tata Institute of Fundamental Research
Sushant Kumar	Singh	Variable Energy Cyclotron Centre, Kolkata
Sushanta	Tripathy	Indian Institute of Technology Indore (IN)
Swagato	Mukherjee	Brookhaven National Laboratory
Szymon	Harabasz	Technische Universität Darmstadt
Taesoo	Song	GSI
Takahiro	Miura	Osaka University
Takahito	Todoroki	RIKEN BNL Research Center
Takashi	Hachiya	Nara Women's University and RIKEN
Taku	Gunji	University of Tokyo (JP)
Takumi	Osako	Hiroshima University (JP)
Tamas	Biro	Wigner RCP
Tan	Luo	IGFAE
Tang	Shi'an	Peking University
Tapan K.	Nayak	CERN, Geneva and NISER, Bhubaneswar
Tatsuya	Chujo	University of Tsukuba (JP)
Tetsufumi	Hirano	Sophia Univ
Tetyana	Galatyuk	TU Darmstadt / GSI
Thomas	Hemmick	Stony Brook University
Tianhao	Shao	Shanghai Institute of Applied Physics
Tiantian	Cheng	Central China Normal University CCNU (CN)
Tianyu	Dai	Duke University
Timothy	Rinn	University Of Illinois (US)
Tiziano	Virgili	Università and INFN, Salerno (IT)
Tom	Reichert	Institut für Theoretische Physik, Goethe Universität Frankfurt
Tomas	Herman	Czech Technical University (CZ)
Tomasz	Bold	AGH Univ. of Science and Technology, Krakow
Tong	Liu	Yale University
Toru	Kojo	Central China Normal University
Toshihiro	Nonaka	Central China Normal University
Travis	Dore	University of Illinois at Urbana-Champaign
Tribhuban	Parida	Indian Institute of Science Education and research,Berhampur
UKACHUKWU	UGOCHUKWU	CHARTJOSSY INVESTMENT LIMITED
Umut	Gursoy	Utrecht University
Urs	Wiedemann	CERN
Vadim	Babkin	Joint Institute for Nuclear Research (RU)
Valerii	Kondratev	St Petersburg State University (RU)
Veronica	Canoa Roman	Stony Brook university
Verônica	Dexheimer	Kent State University
Victor	Roy	National Institute of Science Education and Research
Victoria	Greene	Vanderbilt University (US)
Viktor	Klochkov	GSI / Frankfurt Uni
Vincent	Gaebel	Frankfurt Institute for Advanced Studies
Vit	Kucera	Inha University (KR)
Vito	Manzari	INFN - Bari
Vladimir	Skokov	North Carolina State University
Volker	Koch	LBNL
Vytautas	Vislavicius	University of Copenhagen (DK)
Wanbing	He	Fudan University
wang	fen	qwe
Wei	Chen	UCAS
Wei	Dai	China University of Geosciences
Wei	Li	Rice University (US)
Wei-jie	Fu	Dalian University of Technology
Wei-Liang	Qian	University of Sao Paulo
Weihu	Ma	Fudan University
Weixi	Kong	CCNU
Weiyao	Ke	University of California, Berkeley
Wen-Jing	Xing	Central China Normal University
Wenbin	Zhao	Peking University
Wenchang	Xiang	Guizhou University of Finance and Economics
Wenchao	Zhang	Shaanxi Normal University
Wenda	Guo	Central China Normal University CCNU (CN)
WenHao	Zhou	Shanghai Institute of Applied Physics, CAS
Wenjing	Zhang	Central China Normal University CCNU (CN)
Wenkai	Fan	Duke University
Wenkai	Zou	Columbia University (US)
Wenqing	Fan	Stony Brook University
Wilke	Van Der Schee	CERN
William	Zajc	Columbia University
William Alexander	Horowitz	University of Cape Town (ZA)
Wojciech	Broniowski	UJK & IFJ PAN
Wojciech	Florkowski	Institute of Physics, Jagiellonian University
Wu	Kejun	China Three Gorge University
Xiang	Li	Peking University
Xiang-Yu	Wu	Central China Normal University.
Xianglei	Zhu	Tsinghua University (CN)
Xiangrong	Zhu	Huzhou Universtiy
Xiao-Dan	Wang	CCNU
Xiao-Liang	Xia	Fudan University
Xiaofeng	Luo	Central China Normal University
Xiaojun	Yao	Massachusetts Institute of Technology
Xiaoli	Luo	Shandong University
Xiaolong	Chen	USTC
Xiaoming	Zhang	Central China Normal University CCNU (CN)
Xiaozhi	Bai	GSI-Helmholtzzentrum für Schwerionenforschung
Xiaozhou	Yu	Fudan University
Xin	An	UIC
Xin	Dong	Lawrence Berkeley National Laboratory
Xin-li	Sheng	Institute for theoretical physics, Goethe Uni.
Xin-Nian	Wang	Central China Normal University (China)) / Lawrence Berkeley Na
Xing Long	Li	Central China Normal University CCNU (CN)
Xingrui	Gou	Shandong University
Xingyu	Guo	South China Normal Univeristy
Xinye	Peng	Central China Normal University
Xinyue	Ju	University of Science and Technology of China
Xionghong	He	Institute of Modern Physics, CAS
Xiujun	Li	University of Science and Technology of China
Xiuxiu	Jiang	Central China Normal University CCNU (CN)
Xu-Guang	Huang	Fudan University
Ya	Zhu	Central China Normal University CCNU (CN)
Yacine	Mehtar-Tani	Brookhaven National Laboratory
Yafei	Wang	CCNU
Yalei	Tan	Central China Normal University CCNU (CN)
Yan	Huang	Tsinghua University
Yan	Lu	Wuhan University of Science and Technology
Yanbing	Cai	GuiZhou University of Finance and Economics
Yanchun	Ding	Central China Normal University CCNU (CN)
Yanfang	Liu	TAMU
Yang	He	ShanDongUniversity
Yangguang	Yang	University of Science and Technology of China
Yao	Li	CCNU
Yapeng	Zhang	Institute of Modern Physics, CAS
Yaping	Wang	Central China Normal University CCNU (CN)
Yasuki	Tachibana	Wayne State University
Yasuyuki	Akiba	RIKEN
Yaxian	Mao	Central China Normal University CCNU (CN)
Yayun	He	Central China Normal University
Ye	Lu	Central China Normal University
Yen-Jie	Lee	Massachusetts Inst. of Technology (US)
Yeonju	Go	Korea University (KR)
Yi	Chen	Massachusetts Inst. of Technology (US)
Yi	Chen	University of Chinese Academy of Sciences; Shanghai Institute of Applied Physics, Chinese Academy of Sciences
Yi	Yang	National Cheng Kung University (TW)
Yi	Yin	Institute of Modern physics, Lanzhou
yian	li	Shanghai Inst. of Applied Physics Chinese Academy of Science
Yifei	Zhang	University of Science and Technology of China (CN)
Yifeng	Sun	INFN-LNS
Yiheng	Luo	Tsinghua University (CN)
yilin	cheng	Shanghai Institude of Applied Physics
Yilong	Xie	China University of Geosciences(Wuhan)
Yilun	Du	Department of Physics and Technology, University of Bergen
Yin	Jiang	Beihang University
Yingjie	Zhou	Central China Normal University CCNU (CN)
Yingying	SHI	Shandong University
Yitao	Wu	University of Science and Technology of China (CN)
Yogesh	Kumar	University of Delhi
Yoko	Minato	Nara Women's University (JP)
Yongzhen	Hou	Central China Normal University CCNU (CN)
Yorito	Yamaguchi	Hiroshima University (JP)
Yoshitaka	Hatta	BNL
You	Zhou	Niels Bohr Institute
Youngil	Kwon	Yonsei University (KR)
Yu	Fu	Central China Normal University
Yu	Shi	ccnu
Yu	Zhang	CCNU
Yu	Zhang	Central China Normal University
Yu-Chen	Liu	Fudan University
Yuangfang	Wu	Central China Normal University
Yuanjing	Ji	University of Science and Technology of China
Yuansheng	Zhao	Fudan University
Yuanyuan	Zhang	CCNU, LBL
Yue	Liang	Kent State Univesrsity & Lawrence Berkeley National Laboratory
Yue Hang	Leung	Lawrence Berkeley National Laboratory
Yufei	Liu	Central China Normal University
Yufu	Lin	CCNU && BNL
Yuji	Hirono	Asia Pacific Center for Theoretical Physics
Yuki	Fujimoto	The University of Tokyo
Yuki	Gogun	Sophia University
Yukinao	Akamatsu	Osaka University
Yuko	Sekiguchi	University of Tokyo (JP)
Yukun	Song	University of Jinan
Yun	Guo	Guangxi Normal University
Yuri	Murin	Joint Institute for Nuclear Research (RU)
Yuri	Sato	University of Tsukuba
Yuto	Yoshida	Sophia University
Yuuka	Kanakubo	Sophia Univ.
Yuxin	Liu	Peking University
yuxin	xiao	CCNU
Yuxing	Dang	Central China Normal University CCNU (CN)
Yves	Schutz	IPHC, Strasbourg
Zaochen	Ye	Rice University
Ze Fang	Jiang	Central China Normal University
Zebo	Tang	University of Science and Technology of China (CN)
Zehao	Sun	Shandong University
Zeyan	Wang	Tsinghua University
Zeyu	Zhai	University of Science and Technology of China
Zhan	Bai	Peking University
Zhan	Gao	CCNU
Zhandong	Sun	University of Debrecen
Zhangbu	Xu	Brookhaven National Laboratory
Zhanna	Khabanova	Nikhef National institute for subatomic physics (NL)
zhao	zhang	North China Electric Power University, Beijing, China
Zhaozhong	Shi	Massachusetts Inst. of Technology (US)
Zhe	Xu	Tsinghua University
Zhen	Liu	University of Science and Technology of China and Brookhaven National Laboratory
zhen	wang	Shandong University
Zhengyu	Chen	Tsinghua University
Zhenyu	Chen	Shandong University
Zhenyu	Ye	University of Illinois at Chicago (US)
Zhenyu	Zhu	Goethe University Frankfurt am Main
Zhenzhen	YANG	CCNU/LBNL
Zhiwei	Du	Fudan University
Zhong	Yang	CCNU
Zhong-Bao	Yin	Central China Normal University CCNU (CN)
Zhoudunming	Tu	BNL
Zi-Wei	Lin	East Carolina University, Central China Normal University
Ziming	Liu	Peking University
Ziyang	Li	University of Science and Technology of China
Ziyue	Wang	Tsinghua University
Zoltan	Varga	Hungarian Academy of Sciences (HU)
Zubayer	Ahammed	Department of Atomic Energy (IN)
Zuo-Yun	Wang	CCNU
Zuzana	Moravcova	University of Copenhagen (DK)
Émilien	Chapon	CERN
